date=Interview_Date
sector=User_Sector
received=Received
interviewer=User
uID=Child_UID
InfantName=Child_Name
Sex=Child_Gender
Relationofrespondenttoinfant=Relation
otherrelations=Other_Relation
UpdateStatusforENCC=Update_Status_ENCC
DoestheInfantfit=Baby_Square
Didthebabycryorbreathewithin1minuteofbirth=Cry_Breathe_After_Birth
Wasthebabycryingvigorouslyrightafterbirth=Cry_loudly
Didthebabymoveitslimbsvigorouslyrightafterbirth=Moves_Limbs_Vigorously
Wasanypartofthebodyofthebabyblueatbirth=Blue_Part_at_Birth
wasinformhealthworker=Brac_Referred_After_Birth
HasBreastfeedingbeeninitiated=Start_Breast_Feeding
Haveprelactealsbeenfed=Other_Food
Isthenewborndryandwrappedandkeptwarm=Kept_Warm
Isthebabyheadcovered=Wrapped_Head
Hasthebabybeenbathed=Bathed_After_Birth
Hasanythingbeenplacedontheumbilicus=Clean_Umbilicus
IsthebabyhottotouchORcoldtotouch=TooHot_TooCold
Istherefoulsmellingdischargeorrednessorswellingaroundtheumbilicus=Bad_Smell_Umbilicus
Areanyofthebabylimbsandchestorlipsblue=Any_Part_Blue
Isthebabyskinyellow=Yellow_Skin
Isthebabylethargicornotsucklingproperly=Problem_in_Sucking
Isthebabyhavingdifficultorrapidbreathing=Problem_in_Breathing
Hasthebabyhadanyconvulsionsafterbirth=Problem_Of_Convulsion	
DidyoureferthechildorcallBRACHealthAssistanthome=Brac_Referred_Child
Isthemotherstillbleedingalotorpassinglargeclots=Passing_Blood_Clot_M
Isthemotherstrugglingtobreathewhiledoingmionorworkorwhilespeaking=Struggling_To_Breather_M
Doesthemotherhaveabadheadachethatdoesnotgetbetterevenaftertakingmedicine=Headache_M
Doesthemotherhaveblurredvision=Blur_Vision_M
Doesthemotherhavehighfeversuchthatthebodyishottotouchorshefeelsthatherbodyisburning=Body_Temperature_M
Doesthemotherhavepaininherabdomenandvaginaldischargefromthebirthpassagethatsmellsbad=Pain_in_Abdomen_M
Isthemotherurinatinglessthanusualordoesithurtwhensheurinates=Frequency_of_Urination_M
DidyoureferthemotherorcallBRACHealthAssistanthome=Brac_Referred_M
FormStatus=Form_Status
