received=Received
date=Interview_Date
interviewer=User
sector=User_Sector
Date=MRF_Date
JiVitAWeek=JiVitAWeek
Division=Division
District=District
Upazilla=Upazilla
Ward=Ward
Unions=Union
ACArea=ACArea
TlPin=TL_Pin
Sector=Sector
Mauza=Mauza
uID=UID
JivitaHHID=JiVita_HHID
GoBHHID=GoB_HHID
WomenName=Women_Name
HusbandsName=Husband_Name
WomenAge=Woman_Age
monthandyearofborn=DoB_Month_Year
VisitStatusforMRF=Visit_Status_MRF
DidMWRAprovideconsentforregistration=Reg_Consent
areyoucurrentlypregnant=Current_Pregnancy
Whatwasthedateofyourlastmonstrualperiod=LMP
Didwomenprovideconsenttoconducturinetest=URT_Consent
Doyouusemobilephone=Use_Mobile
Whomdoyousharethephonewith=Share_Mobile
Whocarriesthephonethatyouuse=Owner_of_Mobile
Canyousendatextmessage=Send_SMS
Canyoureadatextmessage=Read_SMS
Wouldyouliketoshareyourmobilenumberwherewe=Share_Number
Pleasespecifymobilenumber=Mobile_Number
Whatwastheresultofpregnancytest=Preg_Test_Result
CaptureGPScoordinate=GPS
FormStatus=Form_Status
